#...##
...#.#.####
.....###..#
##........#
#...@..#..#
#.#..#.#..#
..#.......#
.##....#.##
........##
.#.....##
.#######